#################
#@..............#
#...............#
#...............#
#############...#
#...............#
#...............#
#....############
#...............#
#...............#
#.%.............#
#.............g.#
#.........g.....#
#####..........g#
#B..$...........#
#...#...........#
#################